1111111111
1E0C000001
1C0000C001
100P000001
1111111111