111111111
1PEC00011
100000011
111100001
111111111