111111
1PEC01
100001
111101
111111
111111