1111111111
1E0C000001
1C0000C001
100P000P01
1111111111