1111111111
1E00000001
1C00000001
1P00000001
1111111111